button_chat_accept_count_persistent	standard.view.standard_simod_page_view_dynamic@23
button_chat_all_hotlead_ri_concat_current	standard.view.standard_simod_page_view_dynamic@23
button_chat_all_hotlead_tos_concat	standard.view.standard_simod_page_view_dynamic@23
button_chat_all_offer_ri_concat	standard.view.standard_simod_page_view_dynamic@23
button_interactive_chat_interaction_id_concat_current	standard.view.standard_simod_page_view_dynamic@23
no_of_button_offers_overall	standard.view.repeat_visitor_page_view@45
no_of_hrs_since_last_visit	standard.view.repeat_visitor_page_view@45
no_of_total_connects_overall	standard.view.repeat_visitor_page_view@45
nop_last_visit	standard.view.repeat_visitor_page_view@45
page_12_details	standard.view.standard_simod_page_view_dynamic@23
page_17_details	standard.view.standard_simod_page_view_dynamic@23
page_19_details	standard.view.standard_simod_page_view_dynamic@23
previous_navigation_path	standard.view.standard_simod_page_view_dynamic@23
proactive_chat_all_offer_ri_concat	standard.view.standard_simod_page_view_dynamic@23
proactive_chat_connect_ri_concat_current	standard.view.standard_simod_page_view_dynamic@23
proactive_interactive_chat_count_persistent	standard.view.standard_simod_page_view_dynamic@23
top_08	standard.view.standard_simod_page_view_dynamic@23
top_09	standard.view.standard_simod_page_view_dynamic@23
active_session	standard.view.standard_simod_page_view_dynamic@23
button_chat_all_accept_ri_concat_current	standard.view.standard_simod_page_view_dynamic@23
button_chat_all_accept_tos_concat_current	standard.view.standard_simod_page_view_dynamic@23
button_chat_connect_count_persistent	standard.view.standard_simod_page_view_dynamic@23
last_purchase_order_value	standard.view.repeat_visitor_page_view@45
no_of_hrs_since_last_button_accept	standard.view.repeat_visitor_page_view@45
no_of_hrs_since_last_proactive_accept	standard.view.repeat_visitor_page_view@45
nop_till_proactive_offer	standard.view.standard_simod_page_view_dynamic@23
order_amount	standard.view.standard_simod_page_view_dynamic@23
order_id	standard.view.standard_simod_page_view_dynamic@23
os_cat	standard.view.standard_simod_page_view_dynamic@23
page_08_details	standard.view.standard_simod_page_view_dynamic@23
page_09_details	standard.view.standard_simod_page_view_dynamic@23
page_20_details	standard.view.standard_simod_page_view_dynamic@23
proactive_chat_all_accept_ri_concat_current	standard.view.standard_simod_page_view_dynamic@23
proactive_interactive_chat_ri_persistent	standard.view.standard_simod_page_view_dynamic@23
top_04	standard.view.standard_simod_page_view_dynamic@23
button_chat_all_accept_ri_concat	standard.view.standard_simod_page_view_dynamic@23
button_chat_all_offer_tos_concat_current	standard.view.standard_simod_page_view_dynamic@23
button_chat_connect_ri_concat_current	standard.view.standard_simod_page_view_dynamic@23
button_connect_interaction_id_concat	standard.view.standard_simod_page_view_dynamic@23
day_of_week	standard.view.standard_simod_page_view_dynamic@23
dd	standard.view.standard_simod_page_view_dynamic@23
exit_page_title_last_visit	standard.view.repeat_visitor_page_view@45
no_of_hrs_since_last_interactive	standard.view.repeat_visitor_page_view@45
page_01_details	standard.view.standard_simod_page_view_dynamic@23
page_06_details	standard.view.standard_simod_page_view_dynamic@23
page_16_details	standard.view.standard_simod_page_view_dynamic@23
proactive_chat_all_hotlead_tos_concat	standard.view.standard_simod_page_view_dynamic@23
proactive_connect_interaction_id_concat	standard.view.standard_simod_page_view_dynamic@23
proactive_interactive_chat_interaction_id_concat	standard.view.standard_simod_page_view_dynamic@23
queue_accept_concat_current	standard.view.standard_simod_page_view_dynamic@23
queue_interactive_concat_current	standard.view.standard_simod_page_view_dynamic@23
queue_offer_concat_current	standard.view.standard_simod_page_view_dynamic@23
region	standard.view.standard_simod_page_view_dynamic@23
rv	standard.view.standard_simod_page_view_dynamic@23
top_16	standard.view.standard_simod_page_view_dynamic@23
top_concat	standard.view.standard_simod_page_view_dynamic@23
tp	standard.view.standard_simod_page_view_dynamic@23
vid	standard.view.standard_simod_page_view_dynamic@23
button_chat_connect_ri_persistent	standard.view.standard_simod_page_view_dynamic@23
button_hotlead_flag	standard.view.standard_simod_page_view_dynamic@23
button_interactive_chat_count_persistent	standard.view.standard_simod_page_view_dynamic@23
button_interactive_chat_et_concat_current	standard.view.standard_simod_page_view_dynamic@23
button_interactive_chat_et_persistent	standard.view.standard_simod_page_view_dynamic@23
current_page_title	standard.view.standard_simod_page_view_dynamic@23
no_of_hrs_since_last_connect	standard.view.repeat_visitor_page_view@45
no_of_purchases_last_7_days	standard.view.repeat_visitor_page_view@45
order_units	standard.view.standard_simod_page_view_dynamic@23
page_10_details	standard.view.standard_simod_page_view_dynamic@23
page_11_details	standard.view.standard_simod_page_view_dynamic@23
previous_page_url	standard.view.standard_simod_page_view_dynamic@23
proactive_chat_all_accept_ri_concat	standard.view.standard_simod_page_view_dynamic@23
proactive_chat_all_offer_tos_concat	standard.view.standard_simod_page_view_dynamic@23
proactive_hotlead_flag	standard.view.standard_simod_page_view_dynamic@23
queue_connect_concat_current	standard.view.standard_simod_page_view_dynamic@23
queue_connect_concat_persistent	standard.view.standard_simod_page_view_dynamic@23
queue_hotlead_concat_current	standard.view.standard_simod_page_view_dynamic@23
session_time_last_visit	standard.view.repeat_visitor_page_view@45
top_01	standard.view.standard_simod_page_view_dynamic@23
top_06	standard.view.standard_simod_page_view_dynamic@23
top_13	standard.view.standard_simod_page_view_dynamic@23
button_chat_all_accept_tos_concat	standard.view.standard_simod_page_view_dynamic@23
button_chat_all_hotlead_ri_concat	standard.view.standard_simod_page_view_dynamic@23
button_chat_all_offer_ri_concat_current	standard.view.standard_simod_page_view_dynamic@23
button_interactive_chat_interaction_id_concat	standard.view.standard_simod_page_view_dynamic@23
button_interactive_chat_ri_concat_current	standard.view.standard_simod_page_view_dynamic@23
button_interactive_chat_ri_persistent	standard.view.standard_simod_page_view_dynamic@23
button_offer_count_persistent	standard.view.standard_simod_page_view_dynamic@23
last_purchase_order_units_concat	standard.view.repeat_visitor_page_view@45
no_of_hrs_since_last_purchase	standard.view.repeat_visitor_page_view@45
nop_till_button_offer	standard.view.standard_simod_page_view_dynamic@23
page_03_details	standard.view.standard_simod_page_view_dynamic@23
proactive_chat_accept_count_persistent	standard.view.standard_simod_page_view_dynamic@23
proactive_chat_all_accept_tos_concat	standard.view.standard_simod_page_view_dynamic@23
proactive_interactive_chat_et_concat_current	standard.view.standard_simod_page_view_dynamic@23
proactive_offer_flag	standard.view.standard_simod_page_view_dynamic@23
purchase_flag	standard.view.standard_simod_page_view_dynamic@23
top_18	standard.view.standard_simod_page_view_dynamic@23
button_connect_interaction_id_concat_current	standard.view.standard_simod_page_view_dynamic@23
country	standard.view.standard_simod_page_view_dynamic@23
current_page_url	standard.view.standard_simod_page_view_dynamic@23
exit_page_navpath_last_visit	standard.view.repeat_visitor_page_view@45
no_of_hrs_since_last_button_offer	standard.view.repeat_visitor_page_view@45
no_of_total_interactives_overall	standard.view.repeat_visitor_page_view@45
nop_till_button_accept	standard.view.standard_simod_page_view_dynamic@23
page_05_details	standard.view.standard_simod_page_view_dynamic@23
page_07_details	standard.view.standard_simod_page_view_dynamic@23
proactive_chat_all_offer_ri_concat_current	standard.view.standard_simod_page_view_dynamic@23
proactive_connect_interaction_id_concat_current	standard.view.standard_simod_page_view_dynamic@23
proactive_interactive_chat_et_persistent	standard.view.standard_simod_page_view_dynamic@23
purchase_count_persistent	standard.view.standard_simod_page_view_dynamic@23
queue_pageload_concat_persistent	standard.view.standard_simod_page_view_dynamic@23
top_12	standard.view.standard_simod_page_view_dynamic@23
top_15	standard.view.standard_simod_page_view_dynamic@23
top_17	standard.view.standard_simod_page_view_dynamic@23
version	standard.view.standard_simod_page_view_dynamic@23
browser	standard.view.standard_simod_page_view_dynamic@23
button_chat_accept_flag	standard.view.standard_simod_page_view_dynamic@23
no_of_hrs_since_last_proactive_offer	standard.view.repeat_visitor_page_view@45
no_of_proactive_accepts_overall	standard.view.repeat_visitor_page_view@45
no_of_visits_overall	standard.view.repeat_visitor_page_view@45
nop_till_purchase	standard.view.standard_simod_page_view_dynamic@23
os	standard.view.standard_simod_page_view_dynamic@23
page_02_details	standard.view.standard_simod_page_view_dynamic@23
page_15_details	standard.view.standard_simod_page_view_dynamic@23
previous_page_title	standard.view.standard_simod_page_view_dynamic@23
proactive_chat_accept_flag	standard.view.standard_simod_page_view_dynamic@23
proactive_chat_all_offer_tos_concat_current	standard.view.standard_simod_page_view_dynamic@23
proactive_chat_connect_count_persistent	standard.view.standard_simod_page_view_dynamic@23
proactive_interactive_chat_interaction_id_concat_current	standard.view.standard_simod_page_view_dynamic@23
queue_interactive_concat_persistent	standard.view.standard_simod_page_view_dynamic@23
queue_offer_concat_persistent	standard.view.standard_simod_page_view_dynamic@23
queue_pageload_concat_current	standard.view.standard_simod_page_view_dynamic@23
session_start_server	standard.view.standard_simod_page_view_dynamic@23
top_02	standard.view.standard_simod_page_view_dynamic@23
top_03	standard.view.standard_simod_page_view_dynamic@23
top_10	standard.view.standard_simod_page_view_dynamic@23
top_19	standard.view.standard_simod_page_view_dynamic@23
browser_cat	standard.view.standard_simod_page_view_dynamic@23
button_hotlead_count_persistent	standard.view.standard_simod_page_view_dynamic@23
city	standard.view.standard_simod_page_view_dynamic@23
current_navigation_path	standard.view.standard_simod_page_view_dynamic@23
exit_page_url_last_visit	standard.view.repeat_visitor_page_view@45
hour_of_day	standard.view.standard_simod_page_view_dynamic@23
ip	standard.view.standard_simod_page_view_dynamic@23
no_of_button_accepts_overall	standard.view.repeat_visitor_page_view@45
nop_overall	standard.view.repeat_visitor_page_view@45
nop_till_proactive_accept	standard.view.standard_simod_page_view_dynamic@23
page_18_details	standard.view.standard_simod_page_view_dynamic@23
page_count	standard.view.standard_simod_page_view_dynamic@23
proactive_chat_all_hotlead_ri_concat_current	standard.view.standard_simod_page_view_dynamic@23
proactive_hotlead_count_persistent	standard.view.standard_simod_page_view_dynamic@23
proactive_interactive_chat_ri_concat_current	standard.view.standard_simod_page_view_dynamic@23
proactive_offer_count_persistent	standard.view.standard_simod_page_view_dynamic@23
queue_hotlead_concat_persistent	standard.view.standard_simod_page_view_dynamic@23
referrer	standard.view.standard_simod_page_view_dynamic@23
rt	standard.view.standard_simod_page_view_dynamic@23
session_time	standard.view.standard_simod_page_view_dynamic@23
top_07	standard.view.standard_simod_page_view_dynamic@23
top_11	standard.view.standard_simod_page_view_dynamic@23
top_14	standard.view.standard_simod_page_view_dynamic@23
button_chat_all_hotlead_tos_concat_current	standard.view.standard_simod_page_view_dynamic@23
button_chat_all_offer_tos_concat	standard.view.standard_simod_page_view_dynamic@23
button_offer_flag	standard.view.standard_simod_page_view_dynamic@23
isp	standard.view.standard_simod_page_view_dynamic@23
no_of_proactive_offers_overall	standard.view.repeat_visitor_page_view@45
page_04_details	standard.view.standard_simod_page_view_dynamic@23
page_13_details	standard.view.standard_simod_page_view_dynamic@23
page_14_details	standard.view.standard_simod_page_view_dynamic@23
proactive_chat_all_accept_tos_concat_current	standard.view.standard_simod_page_view_dynamic@23
proactive_chat_all_hotlead_ri_concat	standard.view.standard_simod_page_view_dynamic@23
proactive_chat_all_hotlead_tos_concat_current	standard.view.standard_simod_page_view_dynamic@23
proactive_chat_connect_ri_persistent	standard.view.standard_simod_page_view_dynamic@23
queue_accept_concat_persistent	standard.view.standard_simod_page_view_dynamic@23
top_05	standard.view.standard_simod_page_view_dynamic@23
top_20	standard.view.standard_simod_page_view_dynamic@23
nop_count	standard.view.standard_simod_page_view_dynamic@23